16 16 16 16 16 16 16 16 16 16 16 16 16 16 16 16 16 16 16 16 16 16 16 16 16 16 16 16 16 16 16 16 16 16 16 16 16 16 16 16 16 16 16 16 16 16 16 16 16 16 16 16 16 16 16 16 16 16 16 16 16 16 16 16 16 16 16 16 16 16 16 16 16 16 16 16 16 16 16 16 16 16 16 16 16 16 16 16 16 16 16 16 16 16 16 16 16 16 16 16 
16 16 16 16 16 16 16 16 16 16 16 16 16 16 16 16 16 16 16 16 16 16 16 16 16 16 16 16 16 16 16 16 16 16 16 16 16 16 16 16 16 16 16 16 16 16 16 16 16 16 16 16 16 16 16 16 16 16 16 16 16 16 16 16 16 16 16 16 16 16 16 16 16 16 16 16 16 16 16 16 16 16 16 16 16 16 16 16 16 16 16 16 16 16 16 16 16 16 16 16 
16 16 4 4 5 4 4 4 4 4 4 5 4 4 4 4 17 17 17 17 17 4 5 4 4 4 4 4 4 4 4 4 4 4 5 4 4 4 4 4 4 4 4 4 5 4 4 4 4 4 4 4 4 5 4 4 4 4 4 4 4 4 4 4 4 4 5 4 4 4 4 4 4 4 4 4 4 4 16 16 16 16 16 16 16 16 16 16 16 16 16 16 16 16 0 0 2 16 16 16 
16 16 4 4 4 17 17 17 17 17 4 4 4 4 4 17 17 4 4 4 17 4 4 4 4 4 4 4 4 4 4 4 4 4 4 4 5 4 4 4 4 4 4 4 4 4 5 4 4 4 4 4 4 4 4 4 4 4 4 4 4 4 5 4 4 4 4 4 4 5 4 17 17 17 17 17 4 4 4 16 16 16 16 16 16 16 16 16 16 16 16 16 0 0 0 0 0 16 16 16 
16 16 4 4 4 17 4 4 4 4 17 4 4 4 4 17 4 4 4 4 4 4 4 4 4 4 4 4 5 4 4 4 4 4 4 4 4 4 4 4 5 4 4 4 4 4 4 4 4 4 5 4 4 4 4 5 4 4 4 4 4 4 4 4 17 17 17 17 4 4 4 17 4 4 4 17 17 4 4 4 16 16 16 16 16 16 16 16 16 16 0 0 0 0 0 1 0 16 16 16 
16 16 4 5 17 17 4 4 4 4 4 4 4 5 4 17 17 4 4 17 4 4 4 4 4 4 4 4 4 4 5 4 4 4 4 4 4 4 4 4 4 4 4 4 4 4 4 4 4 4 4 4 4 4 4 4 4 4 4 4 4 17 17 17 17 4 4 17 17 4 4 17 4 4 4 4 4 17 4 4 16 16 16 16 16 16 16 16 0 0 0 0 0 1 0 2 0 16 16 16 
16 16 4 4 17 4 4 4 4 17 17 4 4 4 4 4 17 17 17 17 5 4 4 4 4 4 4 4 4 4 4 4 4 4 4 4 4 4 4 4 4 3 4 4 4 21 4 3 4 4 21 4 3 4 4 4 4 4 5 4 4 17 4 4 4 4 4 4 17 4 17 4 4 4 4 4 4 17 4 4 4 16 16 16 16 16 16 16 0 0 0 0 0 0 0 0 0 0 16 16 
16 16 4 4 17 17 17 4 4 17 4 4 4 4 4 4 4 4 4 4 4 4 4 4 4 4 4 4 4 4 4 4 4 4 4 4 4 4 4 4 4 4 21 4 4 4 4 4 4 4 4 4 4 4 4 4 4 4 4 4 4 17 4 4 4 4 4 4 17 4 17 17 4 4 4 4 17 4 4 4 4 16 16 16 16 16 16 0 0 0 0 0 2 0 0 0 1 0 16 16 
16 16 4 4 4 4 17 17 17 4 4 4 4 4 4 4 17 17 17 4 4 4 4 4 4 5 4 4 4 4 4 4 4 4 4 4 4 3 4 21 4 4 4 4 4 3 4 4 3 4 4 21 4 4 3 4 4 4 4 4 4 17 17 4 4 4 4 17 17 4 4 17 17 4 4 17 17 4 4 4 4 16 16 16 16 16 16 0 0 0 1 0 0 0 0 0 0 0 16 16 
16 16 4 4 4 4 4 4 4 4 4 4 4 4 4 17 17 4 4 17 17 4 5 5 4 4 4 4 4 4 4 4 4 4 4 4 4 4 4 4 4 4 3 4 4 4 4 4 4 4 21 3 4 4 21 4 4 4 4 4 4 4 4 4 4 4 17 17 4 4 4 4 4 4 4 4 4 4 4 5 4 16 16 16 16 16 16 0 0 0 0 0 0 0 0 20 0 0 16 16 
16 16 5 4 4 17 17 4 4 4 4 4 5 4 4 17 4 4 4 4 17 4 4 4 4 4 4 4 4 4 4 4 4 4 4 4 4 4 4 3 4 21 4 4 3 4 4 4 3 4 4 4 4 4 4 4 4 4 4 4 4 4 4 4 17 17 17 4 4 5 4 4 4 4 4 4 4 4 4 4 4 16 16 16 16 16 16 0 0 0 0 0 0 0 0 0 0 0 16 16 
16 16 4 4 17 17 17 17 17 4 4 4 4 4 17 4 4 4 4 4 17 4 4 4 4 4 4 4 4 4 4 4 4 4 4 4 4 21 4 4 4 4 4 4 4 4 4 3 4 4 4 4 3 4 4 3 4 4 4 4 4 4 4 4 4 4 4 4 4 4 4 4 17 17 17 17 4 4 4 4 4 16 16 16 16 16 16 0 0 2 0 0 0 0 0 0 0 0 16 16 
16 16 4 4 17 4 4 4 17 17 4 4 4 4 17 4 4 4 4 4 4 4 4 4 4 4 17 17 17 4 4 4 4 4 4 4 4 4 4 4 4 4 3 4 4 21 4 4 4 21 4 4 4 21 4 4 4 4 4 4 4 4 4 4 4 4 4 4 4 4 17 17 4 4 4 17 4 4 4 4 4 16 16 16 16 16 16 0 0 0 0 1 0 0 0 0 0 0 16 16 
16 16 4 17 17 4 4 4 4 17 17 4 4 4 17 4 4 4 4 4 4 4 4 4 4 17 17 4 17 17 17 4 4 4 4 4 4 4 4 3 4 4 4 4 4 3 4 4 21 4 3 4 4 4 4 21 3 4 4 4 4 4 4 4 4 4 5 4 4 17 17 4 4 4 4 17 4 4 5 4 4 16 16 16 16 16 16 0 0 0 0 0 0 0 0 0 0 0 16 16 
16 16 4 17 4 4 4 4 4 4 4 4 4 4 17 4 4 4 17 17 4 4 4 17 17 17 4 4 4 4 17 4 4 4 4 4 4 4 4 4 4 4 21 4 4 4 3 4 4 4 4 4 4 3 4 4 4 4 4 4 4 4 4 4 4 4 4 4 4 17 4 4 4 4 4 17 4 4 4 4 4 16 16 16 16 16 0 0 0 20 0 0 0 0 0 0 2 1 16 16 
16 16 4 17 17 4 4 4 4 4 4 4 4 4 17 17 17 17 17 4 5 4 4 17 4 4 4 4 4 4 4 4 4 4 4 4 4 3 4 21 4 4 4 3 4 4 4 4 4 3 4 4 21 4 4 21 4 4 4 4 4 4 4 4 4 4 4 4 4 17 4 4 4 4 17 17 4 4 4 4 16 16 16 16 16 16 0 0 0 0 0 1 0 0 0 0 0 0 16 16 
16 16 4 4 17 17 17 4 4 17 17 4 4 4 4 4 4 4 4 4 4 4 4 17 17 4 4 4 17 17 4 4 4 4 4 4 4 4 4 4 4 3 4 4 4 4 4 4 4 4 4 4 4 4 4 4 4 4 4 4 4 4 4 4 4 5 4 4 4 4 4 4 17 17 4 4 4 5 4 4 16 16 16 16 16 0 0 1 0 0 0 0 0 0 0 0 0 0 16 16 
16 16 4 5 4 4 4 17 17 17 4 4 4 5 4 4 4 4 4 4 4 4 4 4 4 17 17 17 17 4 4 4 4 4 4 4 4 4 4 21 4 4 4 4 4 3 4 4 3 4 4 3 4 4 3 4 3 4 4 4 4 4 4 4 4 4 4 4 4 4 4 4 4 4 4 4 4 4 4 16 16 16 16 16 16 0 0 1 0 0 0 0 0 20 0 0 0 0 16 16 
16 16 4 4 4 4 4 4 4 4 4 4 4 4 4 17 17 4 4 4 4 4 4 4 4 4 4 4 4 4 4 4 4 4 4 4 4 4 4 4 4 4 21 4 21 4 4 4 4 4 4 4 4 4 4 4 4 4 4 4 4 4 4 4 4 4 4 4 4 4 4 4 4 4 4 4 4 4 4 16 16 16 16 16 0 0 0 0 0 0 0 0 0 0 0 0 0 0 16 16 
16 16 16 4 4 4 4 4 4 4 4 4 17 17 17 17 4 17 17 4 4 4 4 5 4 4 4 4 5 4 4 4 4 4 4 4 4 5 4 4 4 4 3 4 4 4 21 4 4 4 4 3 4 4 4 4 4 4 4 4 4 4 4 4 4 4 4 4 4 4 4 5 4 4 4 4 4 4 16 16 16 16 16 16 0 0 0 0 2 0 0 0 0 0 0 0 0 0 16 16 
16 16 16 4 4 5 4 4 4 4 4 4 17 4 4 4 4 4 17 4 4 4 4 4 4 4 4 4 4 4 4 4 4 5 4 4 4 4 4 4 21 4 4 4 4 21 4 4 4 3 4 4 4 4 4 4 21 4 4 4 4 4 4 4 4 4 4 4 4 4 4 4 4 4 5 4 4 16 16 16 16 16 16 0 0 0 0 0 0 0 0 0 0 2 0 0 0 0 16 16 
16 16 16 16 4 4 4 4 5 4 4 4 17 4 4 4 4 4 4 4 5 4 4 4 4 17 17 4 4 4 4 4 4 4 4 4 4 4 4 4 4 4 4 21 4 4 4 3 4 4 4 21 4 4 3 4 4 4 4 4 4 4 4 4 4 4 17 17 17 17 17 17 4 4 4 4 16 16 16 16 16 16 0 0 0 0 0 0 0 0 0 0 0 0 0 0 1 0 16 16 
16 16 16 16 16 4 4 4 4 4 4 4 17 4 4 4 4 4 4 4 4 4 4 4 4 17 4 4 4 17 4 4 4 4 4 4 4 4 4 4 4 4 4 4 4 4 4 4 4 4 4 4 4 4 4 4 4 4 4 4 4 4 4 4 4 17 4 4 4 4 4 17 4 4 4 16 16 16 16 16 16 16 0 0 0 0 0 0 0 0 0 0 0 0 0 0 0 0 16 16 
16 16 16 16 16 16 16 16 4 4 5 4 17 4 4 4 4 4 17 4 4 4 4 4 17 17 4 4 4 17 17 4 4 4 4 4 4 4 4 4 4 4 4 4 4 4 4 4 5 4 4 4 4 3 4 4 4 4 4 3 4 4 4 4 4 17 4 4 4 4 17 4 4 4 16 16 16 16 16 16 16 0 0 0 0 0 0 0 0 0 0 0 0 0 0 0 0 0 16 16 
16 16 16 16 16 16 16 16 16 4 4 4 17 17 17 4 4 4 17 4 4 4 4 4 17 4 4 4 4 4 17 4 4 4 4 4 4 4 4 4 5 4 4 4 4 4 4 4 4 4 4 4 4 4 4 4 4 3 4 4 4 4 4 4 4 17 4 4 4 17 17 4 4 16 16 16 16 16 16 16 0 0 0 0 0 0 0 0 0 0 0 0 0 0 0 0 0 0 16 16 
8 7 16 16 16 16 16 16 16 16 16 4 4 5 4 17 17 17 4 4 4 4 4 4 17 4 4 4 4 4 17 17 4 4 4 5 4 4 4 4 4 4 4 4 4 4 4 4 4 4 4 21 21 4 4 4 21 4 4 4 4 4 4 4 4 4 17 4 4 17 4 4 16 16 16 16 16 16 16 0 0 0 0 0 0 0 0 0 0 0 0 0 0 0 0 0 0 0 16 16 
8 7 7 16 16 16 16 16 16 16 16 16 4 4 4 4 4 4 4 4 4 4 4 4 17 4 4 4 4 4 4 17 4 4 4 4 4 4 4 4 4 4 4 4 4 5 4 4 4 4 4 4 4 4 4 4 4 4 4 3 4 4 4 4 4 4 4 4 4 4 4 16 16 16 16 16 16 16 0 0 0 0 0 0 0 0 0 0 0 0 20 0 0 0 0 0 0 0 16 16 
8 6 6 0 0 16 16 16 16 16 16 16 16 16 4 4 4 4 4 4 4 4 5 4 17 17 4 4 4 4 4 17 4 4 4 4 4 4 4 4 4 4 4 4 4 4 4 4 4 4 4 4 4 4 3 4 4 4 4 4 4 4 4 4 4 4 4 4 4 4 4 16 16 16 16 16 16 0 0 0 0 0 0 0 0 0 0 0 0 0 0 0 0 1 0 0 0 0 16 16 
8 8 7 7 0 0 16 16 16 16 16 16 16 16 16 16 4 5 4 4 4 4 4 4 4 17 4 4 4 4 17 17 4 4 4 4 4 4 4 4 4 4 4 4 4 4 4 5 4 4 4 4 4 4 4 4 21 4 4 4 4 4 4 4 4 4 5 4 4 4 16 16 16 16 16 16 0 0 0 0 0 0 0 0 0 0 0 0 0 0 0 0 0 0 0 0 0 0 16 16 
8 8 7 7 0 1 0 16 16 16 16 16 16 16 16 16 16 16 4 4 4 4 4 4 4 4 17 17 4 4 17 4 4 4 4 17 17 4 4 4 17 4 4 4 4 4 4 4 4 4 4 4 4 5 4 4 4 4 4 4 4 4 3 4 4 4 4 4 4 16 16 16 16 16 16 0 0 0 0 1 0 0 0 0 0 0 0 0 0 0 0 0 0 0 2 0 0 0 16 16 
8 8 7 7 7 0 0 0 0 16 16 16 16 16 16 16 16 16 16 4 4 4 5 4 4 4 4 17 17 17 17 4 4 4 17 17 4 4 4 4 4 17 17 17 4 4 4 4 4 4 4 4 4 4 4 4 4 4 4 3 4 4 4 4 4 4 4 4 16 16 16 16 16 16 0 0 0 0 0 0 0 0 0 0 0 0 0 0 0 0 0 0 0 0 0 0 0 0 16 16 
8 8 6 6 7 7 0 0 0 0 0 16 16 16 16 16 16 16 16 16 16 4 4 4 4 4 4 4 4 4 4 4 4 4 17 4 4 4 4 4 4 4 4 17 4 4 4 4 4 4 4 4 4 4 4 4 4 4 4 4 4 21 4 4 3 4 4 16 16 16 16 16 16 0 0 0 0 0 0 0 0 0 0 0 0 0 0 0 0 0 0 0 0 0 0 0 0 0 16 16 
8 8 7 7 8 7 0 0 0 0 1 0 16 16 16 16 16 16 16 16 16 16 16 4 4 4 4 5 4 4 4 4 4 4 17 4 4 4 4 4 4 4 4 17 4 4 4 4 4 4 4 4 4 4 5 5 4 4 4 4 4 3 5 4 4 4 16 16 16 16 16 0 0 0 0 0 0 1 0 0 0 0 0 0 0 2 0 0 0 0 0 1 0 0 0 1 0 0 16 16 
8 8 7 7 7 7 0 0 0 1 0 0 0 16 16 16 16 16 16 16 16 16 16 16 16 4 4 4 4 4 4 4 4 4 4 17 17 4 4 4 4 4 4 17 4 4 4 5 4 4 4 4 4 4 4 4 4 4 4 4 4 4 4 4 21 4 16 16 16 0 0 0 0 0 0 0 0 0 0 0 0 0 0 0 0 0 0 0 0 1 0 0 0 0 0 0 0 0 16 16 
8 8 6 7 7 7 7 0 0 0 0 0 0 0 0 16 16 16 16 16 16 16 16 16 16 16 16 16 4 4 4 4 4 4 5 4 4 17 17 17 4 4 17 17 4 4 4 4 5 4 16 16 16 16 16 16 16 4 4 4 21 4 4 4 4 4 16 0 0 0 0 0 0 0 0 0 0 0 0 0 0 0 0 0 0 0 0 0 0 0 0 0 0 0 0 0 0 0 16 16 
8 8 7 8 7 8 7 0 0 0 0 0 0 1 0 0 0 16 16 16 16 16 16 16 16 16 16 16 16 16 16 16 16 4 4 4 4 4 4 4 17 17 4 4 4 16 16 16 16 16 16 16 16 16 16 16 16 16 16 4 4 4 3 0 0 0 0 0 0 0 0 1 0 0 0 0 0 0 0 0 0 0 0 0 0 0 0 0 0 0 0 0 0 0 0 0 0 16 16 16 
8 8 7 6 7 7 7 7 0 0 0 0 0 0 0 0 0 0 0 16 16 16 16 16 16 16 16 16 16 16 16 16 16 16 16 16 16 16 16 16 16 16 16 16 16 16 16 16 16 16 16 16 16 16 16 16 16 16 16 16 0 0 0 0 0 0 20 0 0 0 0 0 0 0 0 0 0 0 0 0 0 0 0 0 0 0 0 0 0 0 0 0 0 0 0 0 0 16 16 16 
8 8 7 7 7 8 7 7 7 0 1 0 0 0 0 0 0 0 0 0 0 16 16 16 16 16 16 16 16 16 16 16 16 16 16 16 16 16 16 16 16 16 16 16 16 16 16 16 16 16 16 16 16 16 16 16 16 0 0 0 0 0 0 2 0 0 0 0 0 0 0 0 0 0 0 0 0 0 0 0 0 0 0 0 0 0 0 0 0 2 20 0 0 0 0 0 0 16 16 16 
8 8 6 8 7 7 7 8 7 6 0 0 0 0 0 0 0 0 0 0 0 0 0 16 16 16 16 16 16 16 16 16 16 16 16 16 16 16 16 16 16 16 16 16 16 16 16 16 16 16 16 16 16 16 0 0 0 0 0 0 0 0 0 0 20 0 0 0 0 0 0 0 1 1 0 0 0 0 0 0 0 0 0 1 0 0 0 0 0 0 0 0 0 0 0 0 0 16 16 16 
8 8 7 7 8 7 7 7 7 7 0 0 0 0 0 0 1 0 0 0 1 0 0 0 0 0 0 0 0 0 0 16 16 16 16 16 16 16 16 16 16 16 16 16 16 16 16 16 16 0 0 0 0 0 0 0 0 0 0 0 2 0 0 0 0 0 0 0 0 0 0 0 0 0 0 0 0 0 0 0 0 0 0 0 0 0 0 0 0 0 0 0 0 0 0 0 0 16 16 16 
8 8 7 7 7 7 7 6 7 7 7 0 0 1 0 0 0 0 0 0 0 0 0 0 0 0 0 0 0 0 0 0 0 0 0 0 0 0 0 0 0 0 0 0 0 0 0 0 0 0 0 1 0 0 0 0 0 1 0 0 0 0 2 0 0 0 0 2 0 0 0 0 0 0 0 0 0 1 0 0 0 0 0 0 0 0 0 0 0 0 0 0 0 0 0 0 0 16 16 16 
8 8 7 6 7 7 8 7 7 7 7 7 0 0 0 0 0 0 0 0 0 0 0 0 0 0 0 1 0 0 0 0 0 0 1 0 0 0 0 0 0 0 0 0 1 0 0 0 0 0 0 0 0 0 0 0 0 0 0 0 0 0 0 0 2 0 0 0 0 0 0 0 0 0 0 0 0 0 0 0 0 0 0 0 0 0 0 0 0 0 0 0 0 0 0 0 0 16 16 16 
8 8 7 7 7 7 6 7 7 8 7 7 7 0 0 0 1 0 0 0 0 0 0 0 0 0 0 0 0 0 0 0 0 0 0 0 0 0 0 0 0 0 0 0 0 0 0 0 0 0 0 0 0 0 1 0 0 0 0 0 0 20 0 0 0 0 0 0 0 20 0 0 0 0 0 0 0 0 0 0 0 0 0 0 0 0 0 0 0 0 0 0 0 0 1 0 0 16 16 16 
8 8 7 8 7 7 7 7 7 7 7 7 7 7 0 0 0 0 0 0 0 0 0 0 0 0 0 0 0 0 0 0 1 0 0 0 1 0 0 0 0 0 0 0 0 0 0 0 0 0 0 0 0 0 0 0 0 0 0 2 0 0 0 0 0 0 0 0 0 0 0 0 0 0 0 0 0 0 0 0 1 0 0 0 1 0 0 0 0 0 0 0 0 0 0 0 0 16 16 16 
8 8 7 7 7 7 8 7 7 7 6 7 7 7 7 0 0 0 0 0 0 0 0 0 0 0 0 0 0 0 0 0 0 0 0 0 0 0 0 0 0 0 0 0 0 0 0 0 0 0 0 0 0 0 0 0 0 0 0 0 0 0 2 0 0 0 20 0 0 0 0 0 20 0 0 0 0 0 0 0 0 0 0 0 0 0 0 0 0 0 0 0 0 0 0 1 0 16 16 16 
8 8 7 7 6 7 7 7 7 7 8 7 7 7 8 7 0 0 0 0 0 1 0 0 0 0 0 0 0 0 0 0 0 0 0 0 0 0 0 0 0 0 0 0 0 0 0 0 0 0 0 0 0 0 0 0 20 0 0 2 0 0 0 0 0 0 0 0 2 0 0 0 0 0 0 0 0 0 0 0 0 0 0 0 0 0 0 0 0 0 0 1 0 0 0 0 0 16 16 16 
8 8 7 7 7 7 8 7 7 6 7 7 7 6 7 7 7 0 0 0 0 0 0 0 0 0 0 0 1 0 0 0 0 0 0 0 0 0 0 0 0 0 0 0 0 0 0 0 0 0 0 0 0 0 0 0 0 0 2 0 0 0 0 0 20 0 0 0 0 0 0 0 0 0 0 0 0 0 0 0 0 0 0 0 0 0 0 0 0 0 1 0 0 0 0 0 0 16 16 16 
8 8 8 7 7 7 7 7 7 7 7 7 7 7 7 7 7 0 0 0 0 0 0 0 0 0 0 0 0 0 0 0 0 0 0 0 0 0 0 0 0 0 0 0 0 0 1 0 0 0 0 0 0 0 0 0 0 0 0 20 0 2 0 0 0 0 0 0 20 0 0 0 0 0 0 0 0 0 0 0 0 0 0 0 0 0 0 0 0 0 0 0 0 0 0 0 0 16 16 16 
8 8 7 7 8 7 7 6 7 7 7 7 8 7 7 7 8 7 0 0 0 0 0 0 0 0 0 0 0 0 0 0 0 0 0 0 0 1 0 0 0 0 0 0 0 0 0 0 0 0 0 0 0 1 0 0 0 2 0 0 0 0 0 0 0 0 0 0 0 0 0 2 0 0 20 0 0 0 0 0 0 0 0 0 0 0 0 0 0 0 0 0 0 0 0 0 0 16 16 16 
8 8 7 7 7 7 7 7 7 8 7 7 7 7 7 7 7 7 7 0 1 0 0 0 0 0 0 0 0 0 0 0 0 0 1 0 0 0 0 0 0 0 0 0 0 0 0 0 0 0 0 0 0 0 2 0 0 0 0 0 2 0 0 0 0 0 0 0 0 0 0 0 0 0 0 0 17 17 17 17 17 17 17 17 0 0 0 0 0 0 0 0 1 0 1 0 0 0 16 16 
8 8 6 7 7 7 7 7 7 7 7 7 7 7 7 7 7 8 7 7 0 0 0 0 0 0 0 0 0 0 0 0 0 0 0 0 0 0 0 0 0 0 0 0 0 0 0 0 0 0 0 0 0 0 0 0 0 0 0 0 0 0 0 0 0 0 0 0 0 0 0 0 0 0 0 17 4 4 4 4 4 4 4 4 17 0 0 0 0 0 0 0 0 0 0 0 0 0 16 16 
8 8 7 7 7 7 7 8 7 7 6 7 7 7 7 7 7 7 7 7 0 0 0 0 0 0 0 0 1 0 0 0 0 0 0 0 0 0 0 0 0 0 1 0 0 0 0 0 0 1 0 0 0 0 0 0 2 0 0 2 0 0 0 0 0 0 0 0 0 0 0 20 0 0 17 4 4 4 4 4 4 4 4 4 4 17 0 0 0 0 0 0 0 0 0 1 0 0 16 16 
8 8 7 8 7 7 7 6 7 7 7 7 7 8 6 7 7 7 7 7 7 6 0 0 0 0 0 0 0 0 0 0 0 0 0 0 0 0 0 0 0 0 0 0 0 0 0 0 0 0 0 0 0 20 0 0 0 0 0 0 0 0 0 0 0 1 1 0 0 0 0 0 0 2 4 4 4 4 4 4 4 4 4 4 4 17 0 0 0 0 0 0 0 0 0 0 0 0 16 16 
8 8 7 7 7 7 7 7 7 8 7 6 7 7 7 7 7 6 7 7 8 7 0 0 0 0 0 0 0 0 0 0 0 0 0 0 0 0 0 0 0 0 0 0 0 0 0 0 0 0 0 0 0 0 0 0 0 0 0 0 0 0 0 0 0 0 0 0 0 0 0 0 0 0 4 4 4 4 4 4 4 4 4 4 4 17 0 0 0 0 0 0 0 0 0 0 0 0 16 16 
8 8 7 6 7 7 7 7 7 7 7 7 7 7 8 7 7 7 7 7 7 7 7 0 0 0 0 0 0 0 0 0 0 0 0 0 0 0 0 0 0 0 0 0 0 0 0 0 0 0 0 2 0 0 0 2 0 20 0 0 0 0 0 0 0 0 0 0 0 0 0 0 0 0 17 4 4 4 4 4 4 4 4 4 4 17 0 0 0 0 0 0 0 0 0 0 0 0 16 16 
8 8 7 8 7 7 7 7 6 7 8 7 7 8 7 7 6 8 7 7 6 7 7 6 0 0 0 0 0 0 0 0 0 0 0 0 1 0 0 0 0 0 0 0 0 1 0 0 0 0 0 0 0 0 0 0 0 0 0 0 0 0 0 0 0 0 0 0 0 0 0 0 0 0 0 17 17 4 4 4 4 4 4 17 17 0 0 0 0 0 0 0 1 0 0 1 0 0 16 16 
8 8 7 7 7 7 8 7 7 7 7 7 7 7 7 7 7 7 7 7 8 7 7 7 7 0 0 1 0 0 0 0 0 0 0 0 0 0 0 0 0 0 0 0 0 0 0 0 0 0 2 0 0 20 0 0 0 0 0 0 0 0 0 0 0 0 0 0 0 0 0 0 0 0 0 0 0 17 17 17 17 17 17 0 0 0 0 0 0 0 0 0 0 0 0 0 0 0 16 16 
8 8 7 7 7 7 7 7 7 8 7 7 7 6 7 7 7 8 7 7 7 7 7 7 8 7 0 0 0 0 0 0 0 0 0 0 1 0 0 1 0 0 0 0 0 0 0 0 0 0 0 0 0 0 0 0 0 0 0 0 0 0 0 0 0 0 0 0 0 0 0 0 0 1 0 0 0 0 0 0 0 0 0 0 0 0 0 0 0 0 0 0 0 0 0 0 0 0 0 16 
8 8 7 7 8 7 8 7 7 7 7 7 7 7 7 8 7 7 7 7 8 8 7 7 7 7 7 0 0 0 0 0 0 0 0 0 0 0 0 0 0 0 0 0 0 0 0 0 0 0 0 2 0 0 0 0 0 0 0 0 0 0 0 1 0 0 0 0 0 0 0 0 0 0 0 0 0 0 0 0 0 0 0 0 0 0 0 0 0 0 0 0 0 0 0 0 0 0 0 16 
8 8 7 8 7 7 7 7 7 7 7 8 7 7 8 7 7 7 7 7 7 7 7 7 7 8 7 7 0 0 0 0 0 0 0 0 0 0 0 0 0 0 1 0 0 0 2 0 0 0 0 0 0 0 2 0 0 0 0 0 0 0 0 0 0 0 0 0 0 0 1 0 0 0 0 0 0 0 0 0 0 0 0 0 0 0 0 0 0 1 0 0 1 0 0 1 0 0 0 16 
8 8 7 7 7 7 7 7 6 8 7 7 7 7 7 7 7 7 7 7 7 7 7 8 7 7 7 7 7 7 0 0 0 0 0 0 0 0 0 0 0 1 0 0 0 0 0 0 0 0 0 0 0 0 0 0 0 0 0 0 0 0 0 0 0 0 0 0 0 0 0 0 0 0 0 0 0 0 0 0 0 0 0 0 0 1 0 0 0 0 0 0 0 0 0 0 0 0 0 16 
8 8 8 7 7 7 7 7 7 7 7 7 6 7 7 7 7 8 7 8 7 7 7 7 7 7 7 8 8 7 7 0 0 0 0 0 0 0 0 0 0 0 0 0 0 0 0 0 0 0 2 0 0 0 0 0 0 0 0 0 0 0 0 0 0 0 0 0 0 0 0 0 0 0 1 0 0 0 0 0 0 0 0 0 0 0 0 1 0 0 0 0 0 0 0 0 0 0 1 16 
8 8 7 7 7 7 7 8 7 7 7 7 7 8 7 7 7 7 7 7 7 7 7 7 7 8 7 7 7 7 7 7 0 0 0 0 0 0 0 0 0 0 0 0 0 20 0 2 0 0 0 0 20 0 0 0 0 0 0 0 0 0 0 0 0 0 0 0 0 0 0 0 0 0 0 0 0 0 0 0 0 0 0 0 0 0 0 0 0 0 0 0 0 0 0 0 0 0 0 16 
8 8 7 8 7 7 8 7 7 7 7 8 7 7 8 7 7 7 7 7 8 8 8 8 8 7 7 7 8 8 8 8 0 0 0 0 0 0 0 0 2 0 0 2 0 0 0 0 0 2 0 0 0 0 0 0 0 0 0 1 0 0 0 0 0 0 0 0 0 0 0 0 0 0 0 0 0 0 0 0 0 1 0 0 0 0 0 0 0 0 0 0 0 0 0 0 0 0 0 16 
8 8 7 7 7 7 7 8 7 7 7 7 7 7 8 7 7 8 7 8 8 7 7 7 8 7 7 7 8 7 7 8 8 0 0 0 2 0 0 0 0 0 0 0 0 0 0 0 0 0 0 0 0 0 0 0 0 0 0 0 0 0 0 0 0 0 0 1 0 0 0 0 0 0 0 0 0 0 0 0 0 0 0 0 0 0 0 0 0 1 0 0 0 0 1 0 0 0 0 16 
8 8 8 7 7 7 7 6 7 8 7 7 7 6 7 7 7 7 8 7 7 7 7 7 8 7 7 7 8 8 7 7 6 0 0 0 0 0 0 0 0 2 0 0 0 2 0 0 2 0 0 0 0 0 0 0 0 0 0 0 0 0 0 0 0 0 0 0 0 0 0 0 0 0 0 0 0 0 0 0 0 0 0 0 0 0 0 0 0 0 0 0 0 0 0 0 0 0 0 16 
8 8 7 7 8 7 7 7 7 7 7 7 7 7 8 7 7 7 8 7 7 8 7 7 6 7 7 6 7 8 8 7 7 7 0 2 0 0 20 0 0 20 0 0 0 0 0 0 0 0 0 0 0 0 0 0 0 0 0 0 0 0 0 0 0 0 0 0 0 0 0 0 0 0 0 0 0 0 0 0 0 0 0 0 0 0 0 0 0 0 0 0 0 1 0 0 0 0 0 16 
8 8 7 7 7 7 8 8 7 7 8 8 7 7 7 8 8 8 7 7 7 8 7 7 7 7 8 7 7 7 7 7 7 7 7 7 0 0 0 0 0 0 0 20 0 0 0 0 0 0 0 0 0 0 0 0 0 0 1 0 0 0 0 0 0 0 0 0 0 0 0 0 0 0 0 0 0 0 0 0 0 0 0 0 0 0 0 0 0 0 0 0 0 0 0 0 1 0 0 16 
8 8 7 8 8 8 7 7 6 7 7 8 8 8 8 8 7 7 7 8 7 8 7 7 7 7 8 8 8 7 7 7 8 7 7 7 7 2 0 0 2 0 0 0 0 0 0 0 0 0 0 1 0 0 0 0 0 0 0 0 0 0 0 0 0 0 0 0 0 0 0 0 1 0 0 0 0 0 0 0 0 0 0 0 0 0 0 0 0 0 0 0 1 0 0 0 0 0 0 16 
8 8 8 8 7 7 7 7 7 7 7 7 7 7 7 7 7 7 7 7 7 8 7 7 8 7 7 7 8 8 7 6 7 7 7 8 7 7 7 0 0 0 0 0 0 0 0 0 0 0 0 0 0 0 0 0 0 0 0 0 0 0 0 0 0 0 0 0 0 0 0 0 0 0 0 0 0 0 1 0 0 0 0 0 0 0 0 0 0 0 0 0 0 0 0 0 1 0 0 8 
8 8 8 8 7 7 8 7 7 8 8 7 7 6 7 8 8 8 8 7 7 8 7 8 7 7 7 7 7 8 7 7 7 7 8 7 7 7 7 7 8 8 7 0 0 0 0 0 0 0 0 0 0 0 0 0 0 0 0 0 0 0 0 0 0 0 0 0 1 0 0 0 0 0 0 0 0 0 0 0 0 0 0 0 1 0 0 0 0 0 0 0 0 0 0 0 0 0 0 8 
8 8 7 8 8 7 7 7 8 8 7 8 7 7 8 8 7 7 7 7 7 8 7 8 7 7 8 7 7 7 7 7 7 8 8 7 7 8 7 7 7 7 8 8 7 0 0 0 0 0 0 0 0 0 0 0 0 0 0 0 0 0 0 0 0 0 0 0 0 0 0 0 0 0 0 0 0 0 0 0 0 0 0 0 0 0 0 0 0 0 0 0 0 0 0 0 0 0 8 8 
8 8 7 7 8 7 6 8 8 7 7 8 7 8 8 7 6 7 8 7 6 7 8 8 7 7 7 8 8 7 7 7 8 8 7 7 7 7 7 7 7 7 7 7 8 8 7 0 0 0 1 0 0 0 0 0 0 0 0 1 0 1 0 0 0 0 0 0 0 0 0 0 0 0 0 0 0 0 0 0 0 0 0 0 1 0 0 0 0 0 0 0 1 0 0 7 6 7 8 8 
8 8 7 6 7 7 7 8 7 7 7 8 8 7 7 7 7 8 8 7 7 7 7 7 7 7 7 7 8 7 6 7 8 8 8 7 8 8 8 8 7 7 7 7 7 8 7 6 7 0 0 0 0 0 0 0 0 0 0 0 0 0 0 0 0 0 0 0 0 0 0 0 0 0 0 0 0 0 0 1 0 0 0 0 0 0 0 0 0 0 0 0 0 0 7 7 7 7 8 8 
8 8 7 7 7 7 8 8 7 6 7 8 7 7 7 7 8 8 7 8 7 7 7 7 7 7 8 7 8 8 7 7 7 7 7 8 8 7 7 8 8 8 7 7 7 7 7 8 8 7 7 7 0 0 0 0 0 0 0 1 0 0 0 0 0 0 0 0 0 0 0 0 0 0 0 0 0 1 0 0 0 0 0 0 0 0 0 0 1 0 0 0 0 7 7 7 8 7 8 8 
8 8 7 6 7 8 8 7 7 7 7 8 7 8 7 7 8 7 7 7 7 8 7 8 7 7 7 7 7 8 7 7 7 7 7 7 8 8 7 7 7 8 8 8 7 7 7 7 7 8 7 6 7 7 0 0 0 0 0 0 0 0 0 0 0 0 0 0 1 0 0 0 0 0 0 0 0 0 0 0 0 0 0 1 0 0 0 0 0 0 7 7 7 7 7 7 7 7 8 8 
8 8 7 7 8 8 7 7 7 8 8 8 7 7 7 8 8 7 8 7 7 7 8 8 7 7 7 7 7 8 7 7 8 8 7 7 7 8 8 8 7 7 7 8 8 7 7 7 7 7 8 7 7 7 7 6 0 0 0 0 0 0 0 0 0 0 0 0 0 0 0 0 0 0 0 0 0 0 0 0 7 7 6 7 7 7 7 7 7 7 7 7 7 7 6 7 7 7 8 8 
8 8 7 7 8 7 7 7 8 8 7 7 7 7 8 8 7 7 7 7 8 8 8 7 7 8 8 8 7 8 7 7 7 8 7 7 7 7 7 8 8 7 7 7 8 7 6 7 7 7 7 8 8 7 7 6 7 6 7 7 0 0 0 0 0 0 0 0 0 0 0 1 0 0 0 0 0 7 6 7 7 7 7 7 7 7 7 7 7 7 7 7 7 8 7 7 7 6 8 8 
8 8 7 7 8 7 7 7 8 7 7 7 7 8 8 7 7 7 7 8 8 7 7 7 7 8 7 7 7 8 7 7 7 8 8 7 7 7 7 7 8 7 8 7 7 7 8 7 8 7 7 7 7 8 7 7 7 7 7 7 7 7 7 7 7 7 0 0 0 0 0 0 0 7 7 7 7 7 7 7 7 8 7 6 7 7 8 7 7 7 6 7 7 7 7 6 7 7 8 8 
8 8 7 7 8 7 6 7 8 7 7 8 8 8 7 7 7 8 8 7 7 7 7 7 6 8 7 7 7 8 7 7 7 7 8 7 7 7 7 7 8 8 8 7 7 7 8 7 7 7 7 7 7 7 8 8 7 7 7 8 7 6 6 7 7 7 8 7 7 6 7 7 7 7 7 6 6 7 7 7 7 7 7 7 7 7 7 7 7 6 7 7 6 7 7 7 7 7 8 8 
8 8 7 7 7 7 7 7 7 7 7 7 7 7 7 8 8 8 7 7 7 7 7 7 7 8 7 7 7 7 7 7 8 7 8 7 7 7 7 7 8 8 7 6 7 6 7 7 7 7 8 7 7 7 7 7 8 7 7 7 7 7 7 7 7 7 7 7 7 7 7 8 7 7 7 7 7 7 7 7 7 6 7 7 7 7 7 7 7 7 7 7 7 7 7 8 7 7 8 8 
8 8 7 6 7 8 7 7 7 8 7 7 7 8 8 8 7 7 7 8 8 8 8 7 7 8 8 7 7 7 8 8 7 7 8 7 7 7 7 7 8 7 7 7 7 7 8 8 7 7 8 8 8 7 7 7 7 8 7 7 6 7 7 7 7 7 7 7 6 7 7 7 7 7 7 7 7 6 6 7 7 7 7 7 6 7 7 6 7 7 8 7 6 7 7 7 7 7 8 8 
8 8 7 7 7 7 8 7 7 7 7 7 8 8 7 7 7 8 8 8 7 7 7 7 7 7 8 8 7 7 8 8 7 7 8 7 7 7 8 7 7 8 7 7 7 7 8 7 7 7 7 7 8 8 7 7 7 7 8 7 7 7 8 7 6 7 7 7 7 7 7 7 7 7 7 7 7 7 7 7 7 7 7 7 7 8 7 7 7 7 7 7 7 11 9 9 9 9 9 9 
8 8 7 7 8 7 8 8 7 7 7 8 8 7 7 8 8 7 7 7 7 7 7 7 7 8 8 7 8 7 7 7 7 8 7 7 7 7 8 7 7 8 7 7 7 8 8 7 7 8 7 7 7 8 8 7 7 7 7 8 7 7 7 6 7 7 7 8 7 7 7 7 6 7 7 7 7 7 7 7 6 7 7 6 7 7 8 7 7 11 9 9 9 15 13 13 13 13 13 13 
8 8 7 7 8 7 7 8 8 7 7 7 7 7 8 8 7 7 7 7 6 7 7 7 8 8 7 7 7 7 7 6 7 8 7 7 8 8 8 7 7 7 7 7 8 8 7 7 7 7 7 7 7 7 8 8 7 7 7 7 8 7 7 7 7 7 7 7 7 7 7 6 7 7 7 7 7 6 7 7 7 6 7 7 7 7 7 7 11 15 13 13 13 13 13 13 13 13 13 13 
8 8 7 8 8 6 7 7 8 7 7 7 7 8 7 7 7 6 7 7 7 8 8 8 8 8 7 7 7 7 7 7 7 8 7 7 7 7 8 7 7 7 7 8 8 7 7 7 7 7 8 8 7 7 7 8 8 8 7 7 7 8 8 7 7 7 7 7 6 7 6 7 7 7 8 7 7 7 7 7 7 7 7 7 6 7 11 9 15 13 13 14 13 13 13 13 13 13 13 13 
8 8 8 8 7 7 7 7 8 7 7 7 7 8 7 7 8 7 7 7 8 8 7 7 7 8 7 7 7 8 7 7 7 8 8 7 7 8 8 7 7 7 7 8 7 7 7 7 7 7 8 7 7 7 7 7 7 8 8 7 7 7 8 7 7 7 7 7 7 7 7 7 7 7 7 7 7 7 7 7 7 7 7 7 7 7 10 13 13 13 13 13 13 13 13 13 13 14 13 13 
8 8 7 7 7 7 8 8 8 8 8 7 7 8 7 7 8 7 7 8 7 7 7 7 8 8 7 7 7 8 7 7 7 7 8 7 7 8 7 7 7 7 8 7 7 7 7 7 8 8 8 7 8 8 7 7 7 7 7 7 7 7 7 8 7 6 7 7 7 7 7 7 6 7 7 7 7 7 7 7 7 6 6 7 7 11 15 13 13 13 13 13 13 13 13 13 13 13 13 13 
8 8 7 7 8 7 7 7 7 7 8 7 7 8 7 7 8 7 7 8 7 7 7 8 8 7 7 7 8 8 7 7 7 7 8 8 7 8 7 7 7 8 8 7 7 7 8 8 8 7 7 7 8 7 7 7 7 8 8 8 8 8 8 7 7 6 7 7 7 8 7 7 7 7 7 7 7 6 7 7 7 7 7 7 11 15 13 13 14 13 13 13 13 13 13 13 13 13 13 13 
8 8 7 7 7 7 8 7 6 7 7 7 7 8 8 7 7 7 7 7 6 7 7 8 8 8 8 8 8 7 7 7 7 7 7 7 8 8 7 7 8 8 7 7 8 8 8 7 7 7 8 7 7 7 7 8 8 8 7 7 7 6 7 7 7 7 7 7 7 7 7 11 9 18 7 7 7 7 7 7 7 7 7 7 10 13 13 13 14 13 13 13 13 13 13 13 13 14 13 13 
8 8 6 7 6 7 7 7 7 7 7 8 7 7 8 7 7 8 8 7 7 7 7 8 8 8 7 7 7 7 7 8 7 7 7 7 7 8 7 7 7 7 8 8 8 7 7 7 8 7 7 7 7 7 8 8 7 7 6 7 7 7 7 7 7 7 6 7 7 11 9 15 13 19 9 18 7 7 7 6 7 7 7 11 15 13 13 13 13 13 13 13 13 14 14 13 13 13 13 13 
8 8 7 7 8 8 8 8 7 7 7 7 7 7 7 7 7 7 7 7 7 8 8 8 7 7 7 7 7 7 8 8 7 7 7 7 7 8 6 7 7 7 7 7 7 7 7 7 7 7 7 8 8 8 8 7 7 7 7 7 8 8 7 7 8 7 7 7 11 15 13 13 13 13 13 19 18 7 7 7 7 11 9 15 13 13 13 13 13 13 13 13 13 13 13 13 13 13 13 13 
8 8 7 7 8 7 7 7 8 8 7 7 7 7 7 8 8 7 7 8 8 8 7 7 7 7 7 7 7 8 8 7 7 7 8 7 7 8 7 7 6 7 7 7 7 7 7 7 8 8 8 8 7 7 7 7 7 7 6 7 8 8 7 7 7 7 7 7 10 13 13 13 13 13 13 13 19 9 9 9 9 15 13 13 13 13 13 13 13 13 14 13 13 13 13 13 13 13 13 13 
8 8 7 7 8 8 7 7 8 6 8 8 8 7 7 8 7 7 8 8 7 7 7 7 7 8 7 7 8 8 7 7 7 7 7 7 7 7 7 7 7 7 7 7 8 8 8 8 7 7 7 7 7 7 7 7 7 7 7 7 8 7 7 7 7 7 11 9 15 13 13 13 13 13 13 13 13 13 13 13 13 13 13 13 13 13 13 13 13 13 13 13 13 13 13 13 13 13 13 13 
8 8 7 7 8 7 7 6 8 7 7 7 8 7 8 7 7 7 8 7 7 7 7 8 8 7 7 7 8 7 7 7 8 8 7 7 7 7 7 7 8 8 8 8 7 7 7 7 7 7 7 7 8 8 8 8 8 8 7 7 7 8 7 7 7 11 15 13 13 13 13 13 13 13 13 13 13 13 13 13 13 13 13 14 14 13 13 13 13 13 13 13 13 13 13 13 13 13 13 13 
8 8 7 6 8 6 7 7 6 8 8 7 8 8 8 8 8 8 7 7 7 7 8 8 7 7 7 7 8 7 7 7 7 7 8 8 8 8 8 8 8 7 7 7 7 7 7 7 7 7 8 8 8 7 7 7 7 8 8 7 7 7 7 7 11 15 13 13 13 13 13 13 13 13 13 13 13 13 13 13 13 13 13 13 13 13 13 13 13 13 13 13 13 13 13 13 13 13 13 13 
8 8 7 7 8 7 7 7 7 6 7 7 7 7 7 7 7 7 7 7 8 7 8 7 7 8 7 7 8 7 7 7 7 6 7 7 7 6 7 7 7 7 7 7 8 7 7 7 8 8 8 7 7 7 7 7 7 7 7 6 7 7 8 11 15 13 13 13 13 13 13 13 13 14 13 13 13 13 13 13 13 13 13 13 13 13 13 13 13 14 13 13 13 13 13 13 13 13 13 13 
8 8 7 7 8 7 6 7 7 7 7 7 7 7 7 7 7 7 7 7 7 7 8 8 7 7 7 8 7 7 7 7 7 7 7 7 7 7 7 7 7 7 7 7 7 7 7 7 8 7 7 7 7 7 7 7 7 7 7 7 7 7 7 10 13 13 13 13 13 13 13 13 13 13 13 13 13 13 13 13 14 13 13 13 13 14 13 13 13 13 13 13 13 13 13 13 13 13 13 13 
8 8 8 8 8 8 8 8 8 8 8 8 8 8 8 8 8 8 8 8 8 8 8 8 8 8 8 8 8 8 8 8 8 8 8 8 8 8 8 8 8 8 8 8 8 8 8 8 8 8 8 8 8 8 8 8 8 8 8 8 8 8 8 10 13 13 13 13 13 13 13 13 13 13 13 13 13 13 13 13 13 13 13 13 13 13 13 13 13 13 13 13 13 13 14 13 13 13 13 13 
8 8 8 8 8 8 8 8 8 8 8 8 8 8 8 8 8 8 8 8 8 8 8 8 8 8 8 8 8 8 8 8 8 8 8 8 8 8 8 8 8 8 8 8 8 8 8 8 8 8 8 8 8 8 8 8 8 8 8 8 8 8 8 10 13 13 13 13 13 13 13 13 14 13 13 13 14 13 13 13 13 13 13 13 13 14 13 13 13 13 13 13 13 13 13 13 13 13 13 13 
